$ANSIBLE_VAULT;1.1;AES256
38663864643438323538383132363936666566346665636135366232306163646436633537633165
3530666135323439623933303534633531383161383434340a366536663839396631383836336466
66633835343931313137366361386639363839666238666531326132643231343535376363303739
3830623135353261340a343830653565633434306539316166653964333230633732333635363634
63646565353663656466643363663065663063663037373563633364323363643635626461643530
36656232336462303135376139323766643435353237346137383331303136343366396536333030
39383833303436633233613064333263616363663836306334393162613862376138353066643962
63383266626136336538383366373836633762336536316161663433663534653063633836383131
31613863366637393934643361363932613235643365623334363939396131663637623030383330
38653131656630616237363961333032393437616464623037643835333165376262366663303533
65666663653133333132336332346233383632363630616362643138646664626262333061336532
39343838363931346538313363616537616464373630383332623636393362633534626638326239
32373265376234373862383634653136313766386130323237383766636464616430653438663630
37363236396233366264366264636135653464303465373766656166353363373938333066393563
65646532616263333439653134643134613561613766323431633434333239656230626236663130
33316436313533383263346338323964353462633235646664326130616335646565653361653836
61623163393262353534303664656462623231663762373864383930626233646362316235343134
34643261366437303931366239333433653666383464663439333966353230656336383764373836
30346463616530346666656230633837636262373666396330376535343063643964303064323937
63326336656130623066386333336631663636396264316532336464306462313537326637663239
36633662393538643839383634323339633365323266366331323161313137633737626364363039
32306130393536656365306438373661393932306563663536663533343531373438646163363634
61633637363738326639653963353065366265396134623939663162663430323565313163383239
64373166393032393732
