$ANSIBLE_VAULT;1.1;AES256
62623835336437356165646364353631323564353635653432333537653836653733323962306163
3531396431393331343165363432663035636162316638620a306666393732353831343736363862
62333438643736316662656164326438346162313733336664303735373866633262323163666564
6661613637326633390a633264653765383635663730623539626437656565393864356436616432
38376664636566653764353663306564663134303930326661386234646336613532616166383163
65653536326134333631363236303039623666393434386137373666353932326466653731343362
62363465663233393137623865386333663832333431636639306362336362613965643462313935
33333733373362613937643733643232383663383931393639373562336164393464623430383162
36343232333865373630663438383132663034353138656162396238313830363935353032636163
65626230633430653138333161396466376264623633643437303065666531343762383365633630
32613431313236316430626536333262323434633531313765303963343264313530316139393062
64303665316531646533333434613939646634366130336366323033633232336534663565386261
64356263396537356132306539666536373632666437666138333865323065313261333966666438
33323435643465346130623165653563616566343130306237376163343037656338386239393239
65306338373264666439343734323031663839383836396634323265626164666531626336376265
33616266316530343864326435376133363465316562633739313931343439386463386537383533
35323635383139386666623437663934396665383436356365623332623331636530326665396333
6462666163306532316138343761313432333639383561626636
