$ANSIBLE_VAULT;1.1;AES256
66336339326331373265393733333837626462373530326635396632386639633661623337316365
3766333030656662343235616163636466356534623665310a666635616466333836313765373939
30666466366364663236313333333030623833623532343261643232376338326161336563613961
3764306462393230310a343834373434393331653564323066373264376337333264363365383762
64656532633333313866656534396435333837373234363263373066396537323238323831393839
37613439373763343633353132643861393130316339643631313862636437383330373265643362
30383361323438336537363065393439346366316532386363373535383764306263623930623633
62636135313833666665
