$ANSIBLE_VAULT;1.1;AES256
65303065663235656331396533623466636538383265613037306364663434356638393564323663
6364646433643533663639366231646164303664613538320a653263666331303431646165333730
30396530346233313535393031623334383630653135326363613465306131353138353061396432
3864393863633735620a353139663937626236656137653633343864656331316661393064333930
34636663306262316561303732316437643964323763343636306563656235313736333861636337
30393636633132646632386433326334303339636365643433353639313337386561363236373332
37386235613130353537333763646365323336333536616364366630623037396363366165383062
62303532653630383032346430666363383638653536393866646564356133393662376665343830
64663263643939376536383339396438636161646465316238373865363239616263633738623464
30333163643236303762623731613866613733613965633532343636376562613438666165643139
65326331353734623136656661643338386536646464633533633638336562363663303865663636
63666331373637626566376161383564313936396135343132626335633836326530356534356535
63313761386363646163373766363737303333326566373265376264663533663962663965373435
63363030383934356162333861333464653833363633346336373034363166353566383464313965
38326161396135303838636439383561616532343566646562383037633630626631613237313462
37653661303861633764653564643361623932653534303530383761643738323063633131353962
66653732656538663032323535363765306136373366306266656335376164323137346234373564
38376263623637616236333430663966366637663030336235663764613239383632306436613961
66333463323432666535383032636561633163663935346331353863343738616362663666346664
31326362663530396365376464666138336539323034656563326563353034333564396361613737
33623462323232346530643462636464653533316564363862613036623338623839636130623265
38623965343930386134663061663262666362633832356238653230386136633733373163366139
65643362653131353032653630303962613465376232383438636365653037366634353932386563
61616234383332626538326430623361613262663432666438326336363163336665396334373864
62623539393335636162646333343730363336313931313636623861623230303561
